#### Quality (Emergent) -> Style -> Name

tagEmergentGlob=铁之球体
tagEmergentGlobDesc=^r仍带余温。

#### TIER 0 ####
tagEmergentTier0=无形

#### TIER 1 ####
tagEmergentTier1=初生
tagStylePhysical=粉碎
tagStyleFire=燃烧
tagStyleCold=冰封
tagStyleLightning=电击
tagStylePoison=腐蚀
tagStylePierce=切割
tagStyleLife=抽取生命
tagStyleAether=腐化
tagStyleChaos=吞噬
tagStyleElemental=脉动

#### TIER 2 ####
tagEmergentTier2=萌芽
tagWeaponAttack=敏捷
tagWeaponCast=迅捷
tagArmorHealth=强韧
tagArmorArmor=坚决

#### Tier 3 ####
tagEmergentTier3=成长
tagOAFlat=锐利
tagDAFlat=灵巧
tagArmorPercent=加固
tagRegenFlat=再生

#### Tier 4 ####
tagEmergentTier4=精炼
tagStyleProcDamageAoEMelee=暴徒之
tagStyleProcDamageAoESpark=突击者之
tagStyleProcDefensive=防御者之
tagStyleProcDefensiveAura=守护者之
tagStyleProcRR=腐化者之
tagStyleStats=毁灭者之

#### Generic Names ####
tagEmergentSword1H=剑
tagEmergentSword2H=双手剑
tagEmergentAxe1H=劈斧
tagEmergentAxe2H=巨斧
tagEmergentMace1H=槌
tagEmergentMace2H=重槌
tagEmergentDagger=匕首
tagEmergentScepter=权杖
tagEmergentPistol=手枪
tagEmergentRifle=步枪
tagEmergentShield=盾牌
tagEmergentFocus=典籍

tagEmergentAmulet=宝石
tagEmergentRing=戒指
tagEmergentMedal=徽章

tagEmergentHelmetMedium=头巾
tagEmergentHelmetCaster=头冠
tagEmergentHelmetHeavy=头盔

tagEmergentShouldersMedium=肩饰
tagEmergentShouldersHeavy=肩甲

tagEmergentTorsoMedium=胸甲
tagEmergentTorsoCaster=法袍
tagEmergentTorsoHeavy=板甲

tagEmergentHandsMedium=手套
tagEmergentHandsHeavy=护手

tagEmergentBootsMedium=护胫
tagEmergentBootsHeavy=战靴

tagEmergentLegsMedium=护腿
tagEmergentLegsHeavy=腿甲

tagEmergentBelt=腰带